111111
10P1E1
101001
100C11
111111